{
    "id": "1",
    "name": "Default",
    "matrix": [
        [0, -1, -1, -1, -1, -1, -1, -1],
        [2, -1, -1, -1, -1, -1, -1, -1],
        [-1, 1, -1, -1, -1, -1, -1, -1],
        [-1, 4, 5, 6, 7, 8, 9, -1],
        [-1, -1, -1, -1, 10, 11, -1, -1],
        [-1, -1, -1, 2, -1, -1, -1, -1],
        [-1, -1, -1, -1, -1, -1, -1, -1],
        [4, -1, -1, -1, -1, -1, -1, 3]
    ]
}